1111111111111111111111111111111111
1000000000000000000000000000000001
1000000000000C00000000000000000001
1000P0000000000000000000C000000001
10C0000E000000000000000000000C0001
1111111111111111111111111111111111
