111111111
100000C11
1P000000111111
1E0000001
1111111110000
