111111111
100000C11
1P0000001
1E0000001
111111111
