1111111111
100000C111
1111P11111
1000000001
111111E111
1111111111
