1111111111111111111111111
100000000C00000000000C001
1000000000000000000000001
100000000C000000C00000001
1E0000000000000000000P001
1111111111111111111111111
