11111111
1000P001
1C001001
111111E1
11111111
